1111111111|0
1001111111|1
1101111111|2
1100000001|3
1111111111|4
1110111101|5
1110111101|6
1110111101|7
1110111101|8
1110000001|9
1111111111|10
0123456789