11111111111
10111111111
10111111111
10110000001
10110111101
10110111101
10110111101
10000000001
11111111011
11111111111