1111111111
1001111111
1100111111
1110111111
1110000111
1111110111
1111110111
1111110111
1111110111
1111110001
1111111111