1111111111
1001111111
1101111111
1100000001
1110111111
1110111111
1111111111
1111111111
1111111111
1111111111
1111111111