1111111111|0
1000000001|1
1011111101|2
1000000001|3
1011111101|4
1011111101|5
1011111101|6
1011111101|7
1000000001|8
1011111111|9
1111111111|10
0123456789