1111111111|0
1111111111|1
1111111111|2
1000000001|3
1011111111|4
1011110111|5
10110001111|6
1011010111|7
1000010111|8
1011111111|9
1111111111|10
0123456789