111111111111
101111111101
100000000001
101110111101
101110111111
100000111111
101111111111
101111111111
101111111111
101111111111
100000010001
111111111111