11111111111111
10111111111111
10000000000001
11111110111101
11111110000001
11111111111101
11111111111101
11111111111111