1111111111|0
1001111111|1
1101111111|2
1100000001|3
1111101111|4
1111101111|5
1111101111|6
1110101111|7
1111111111|8
1111111111|9
1111111111|10
0123456789