111111111111
101111111111
101111111111
101111111111
101111111111
101111111111
101111111111
100000000001
101111111101
100111111101
100000000001
111111111111