111111111111
100000000001
101111011101
101111011101
101111011101
101111011101
101111011101
101111011101
100011011101
101011011101
100000000001
111111111111