111111111111
101111111111
101111111111
101111111111
101100000001
101101111101
101101111101
100001111101
101001111101
101001111101
100000000001
111111111111