111111111111
101000000001
111100000101
100000111101
101110111101
101110111101
101000000101
101110111101
101110111101
101111111111
100000000101
111111111111